Rank,NOC,Gold,Silver,Bronze,Total,year
1,Soviet Union,55,31,46,132,1988
2,East Germany,37,35,30,102,1988
3,United States,36,31,27,94,1988
4,South Korea,12,10,11,33,1988
5,West Germany,11,14,15,40,1988
6,Hungary,11,6,6,23,1988
7,Bulgaria,10,12,13,35,1988
8,Romania,7,11,6,24,1988
9,France,6,4,6,16,1988
10,Italy,6,4,4,14,1988
11,China,5,11,12,28,1988
12,Great Britain,5,10,9,24,1988
13,Kenya,5,2,2,9,1988
14,Japan,4,3,7,14,1988
15,Australia,3,6,5,14,1988
16,Yugoslavia,3,4,5,12,1988
17,Czechoslovakia,3,3,2,8,1988
18,New Zealand,3,2,8,13,1988
19,Canada,3,2,5,10,1988
20,Poland,2,5,9,16,1988
21,Norway,2,3,0,5,1988
22,Netherlands,2,2,5,9,1988
23,Denmark,2,1,1,4,1988
24,Brazil,1,2,3,6,1988
25,Finland,1,1,2,4,1988
26,Spain,1,1,2,4,1988
27,Turkey,1,1,0,2,1988
28,Morocco,1,0,2,3,1988
29,Austria,1,0,0,1,1988
30,Portugal,1,0,0,1,1988
31,Suriname,1,0,0,1,1988
32,Sweden,0,4,7,11,1988
33,Switzerland,0,2,2,4,1988
34,Jamaica,0,2,0,2,1988
35,Argentina,0,1,1,2,1988
36,Chile,0,1,0,1,1988
37,Costa Rica,0,1,0,1,1988
38,Indonesia,0,1,0,1,1988
39,Iran,0,1,0,1,1988
40,Netherlands Antilles,0,1,0,1,1988
41,Peru,0,1,0,1,1988
42,Senegal,0,1,0,1,1988
43,Virgin Islands,0,1,0,1,1988
44,Belgium,0,0,2,2,1988
45,Mexico,0,0,2,2,1988
46,Colombia,0,0,1,1,1988
47,Djibouti,0,0,1,1,1988
48,Greece,0,0,1,1,1988
49,Mongolia,0,0,1,1,1988
50,Pakistan,0,0,1,1,1988
51,Philippines,0,0,1,1,1988
52,Thailand,0,0,1,1,1988
1,Unified Team,45,38,29,112,1992
2,United States,37,34,37,108,1992
3,Germany,33,21,28,82,1992
4,China,16,22,16,54,1992
5,Cuba,14,6,11,31,1992
6,Spain*,13,7,2,22,1992
7,South Korea,12,5,12,29,1992
8,Hungary,11,12,7,30,1992
9,France,8,5,16,29,1992
10,Australia,7,9,11,27,1992
11,Canada,7,4,7,18,1992
12,Italy,6,5,8,19,1992
13,Great Britain,5,3,12,20,1992
14,Romania,4,6,8,18,1992
15,Czechoslovakia,4,2,1,7,1992
16,North Korea,4,0,5,9,1992
17,Japan,3,8,11,22,1992
18,Bulgaria,3,7,6,16,1992
19,Poland,3,6,10,19,1992
20,Netherlands,2,6,7,15,1992
21,Kenya,2,4,2,8,1992
22,Norway,2,4,1,7,1992
23,Turkey,2,2,2,6,1992
24,Indonesia,2,2,1,5,1992
25,Brazil,2,1,0,3,1992
26,Greece,2,0,0,2,1992
27,Sweden,1,7,4,12,1992
28,New Zealand,1,4,5,10,1992
29,Finland,1,2,2,5,1992
30,Denmark,1,1,4,6,1992
31,Morocco,1,1,1,3,1992
32,Ireland,1,1,0,2,1992
33,Ethiopia,1,0,2,3,1992
34,Algeria,1,0,1,2,1992
35,Estonia,1,0,1,2,1992
36,Lithuania,1,0,1,2,1992
37,Switzerland,1,0,0,1,1992
38,Jamaica,0,3,1,4,1992
39,Nigeria,0,3,1,4,1992
40,Latvia,0,2,1,3,1992
41,Austria,0,2,0,2,1992
42,Namibia,0,2,0,2,1992
43,South Africa,0,2,0,2,1992
44,Belgium,0,1,2,3,1992
45,Croatia,0,1,2,3,1992
46,Independent Olympic Participants,0,1,2,3,1992
47,Iran,0,1,2,3,1992
48,Israel,0,1,1,2,1992
49,Chinese Taipei,0,1,0,1,1992
50,Mexico,0,1,0,1,1992
51,Peru,0,1,0,1,1992
52,Mongolia,0,0,2,2,1992
53,Slovenia,0,0,2,2,1992
54,Argentina,0,0,1,1,1992
55,Bahamas,0,0,1,1,1992
56,Colombia,0,0,1,1,1992
57,Ghana,0,0,1,1,1992
58,Malaysia,0,0,1,1,1992
59,Pakistan,0,0,1,1,1992
60,Philippines,0,0,1,1,1992
61,Puerto Rico,0,0,1,1,1992
62,Qatar,0,0,1,1,1992
63,Suriname,0,0,1,1,1992
64,Thailand,0,0,1,1,1992
1,United States,44,32,25,101,1996
2,Russia,26,21,16,63,1996
3,Germany,20,18,27,65,1996
4,China,16,22,12,50,1996
5,France,15,7,15,37,1996
6,Italy,13,10,12,35,1996
7,Australia,9,9,23,41,1996
8,Cuba,9,8,8,25,1996
9,Ukraine,9,2,12,23,1996
10,South Korea,7,15,5,27,1996
11,Poland,7,5,5,17,1996
12,Hungary,7,4,10,21,1996
13,Spain,5,6,6,17,1996
14,Romania,4,7,9,20,1996
15,Netherlands,4,5,10,19,1996
16,Greece,4,4,0,8,1996
17,Czech Republic,4,3,4,11,1996
18,Switzerland,4,3,0,7,1996
19,Denmark,4,1,1,6,1996
20,Turkey,4,1,1,6,1996
21,Canada,3,11,8,22,1996
22,Bulgaria,3,7,5,15,1996
23,Japan,3,6,5,14,1996
24,Kazakhstan,3,4,4,11,1996
25,Brazil,3,3,9,15,1996
26,New Zealand,3,2,1,6,1996
27,South Africa,3,1,1,5,1996
28,Ireland,3,0,1,4,1996
29,Sweden,2,4,2,8,1996
30,Norway,2,2,3,7,1996
31,Belgium,2,2,2,6,1996
32,Nigeria,2,1,3,6,1996
33,North Korea,2,1,2,5,1996
34,Algeria,2,0,1,3,1996
35,Ethiopia,2,0,1,3,1996
36,Great Britain,1,8,6,15,1996
37,Belarus,1,6,8,15,1996
38,Kenya,1,4,3,8,1996
39,Jamaica,1,3,2,6,1996
40,Finland,1,2,1,4,1996
41,FR Yugoslavia,1,1,2,4,1996
42,Indonesia,1,1,2,4,1996
43,Iran,1,1,1,3,1996
44,Slovakia,1,1,1,3,1996
45,Armenia,1,1,0,2,1996
46,Croatia,1,1,0,2,1996
47,Portugal,1,0,1,2,1996
48,Thailand,1,0,1,2,1996
49,Burundi,1,0,0,1,1996
50,Costa Rica,1,0,0,1,1996
51,Ecuador,1,0,0,1,1996
52,Hong Kong,1,0,0,1,1996
53,Syria,1,0,0,1,1996
54,Argentina,0,2,1,3,1996
55,Namibia,0,2,0,2,1996
56,Slovenia,0,2,0,2,1996
57,Austria,0,1,2,3,1996
58,Malaysia,0,1,1,2,1996
59,Moldova,0,1,1,2,1996
60,Uzbekistan,0,1,1,2,1996
61,Azerbaijan,0,1,0,1,1996
62,Bahamas,0,1,0,1,1996
63,Chinese Taipei,0,1,0,1,1996
64,Latvia,0,1,0,1,1996
65,Philippines,0,1,0,1,1996
66,Tonga,0,1,0,1,1996
67,Zambia,0,1,0,1,1996
68,Georgia,0,0,2,2,1996
69,Morocco,0,0,2,2,1996
70,Trinidad and Tobago,0,0,2,2,1996
71,India,0,0,1,1,1996
72,Israel,0,0,1,1,1996
73,Lithuania,0,0,1,1,1996
74,Mexico,0,0,1,1,1996
75,Mongolia,0,0,1,1,1996
76,Mozambique,0,0,1,1,1996
77,Puerto Rico,0,0,1,1,1996
78,Tunisia,0,0,1,1,1996
79,Uganda,0,0,1,1,1996
1,United States,37,24,32,93,2000
2,Russia,32,28,29,89,2000
3,China,28,16,14,58,2000
4,Australia,16,25,17,58,2000
5,Germany,13,17,26,56,2000
6,France,13,14,11,38,2000
7,Italy,13,8,13,34,2000
8,Netherlands,12,9,4,25,2000
9,Cuba,11,11,7,29,2000
10,Great Britain,11,10,7,28,2000
11,Romania,11,6,9,26,2000
12,South Korea,8,10,10,28,2000
13,Hungary,8,6,3,17,2000
14,Poland,6,5,3,14,2000
15,Japan,5,8,5,18,2000
16,Bulgaria,5,6,2,13,2000
17,Greece,4,6,3,13,2000
18,Sweden,4,5,3,12,2000
19,Norway,4,3,3,10,2000
20,Ethiopia,4,1,3,8,2000
21,Ukraine,3,10,10,23,2000
22,Kazakhstan,3,4,0,7,2000
23,Belarus,3,3,11,17,2000
24,Canada,3,3,8,14,2000
25,Spain,3,3,5,11,2000
26,Turkey,3,0,2,5,2000
27,Iran,3,0,1,4,2000
28,Czech Republic,2,3,3,8,2000
29,Kenya,2,3,2,7,2000
30,Denmark,2,3,1,6,2000
31,Finland,2,1,1,4,2000
32,Austria,2,1,0,3,2000
33,Lithuania,2,0,3,5,2000
34,Azerbaijan,2,0,1,3,2000
35,Bahamas,2,0,1,3,2000
36,Slovenia,2,0,0,2,2000
37,Switzerland,1,6,2,9,2000
38,Indonesia,1,3,2,6,2000
39,Slovakia,1,3,1,5,2000
40,Mexico,1,2,3,6,2000
41,Nigeria,1,2,0,3,2000
42,Algeria,1,1,3,5,2000
43,Uzbekistan,1,1,2,4,2000
44,FR Yugoslavia,1,1,1,3,2000
45,Latvia,1,1,1,3,2000
46,New Zealand,1,0,3,4,2000
47,Estonia,1,0,2,3,2000
48,Thailand,1,0,2,3,2000
49,Croatia,1,0,1,2,2000
50,Cameroon,1,0,0,1,2000
51,Colombia,1,0,0,1,2000
52,Mozambique,1,0,0,1,2000
53,Brazil,0,6,6,12,2000
54,Jamaica,0,6,3,9,2000
55,Belgium,0,2,3,5,2000
56,South Africa,0,2,3,5,2000
57,Argentina,0,2,2,4,2000
58,Chinese Taipei,0,1,4,5,2000
59,Morocco,0,1,4,5,2000
60,North Korea,0,1,3,4,2000
61,Moldova,0,1,1,2,2000
62,Saudi Arabia,0,1,1,2,2000
63,Trinidad and Tobago,0,1,1,2,2000
64,Ireland,0,1,0,1,2000
65,Sri Lanka,0,1,0,1,2000
66,Uruguay,0,1,0,1,2000
67,Vietnam,0,1,0,1,2000
68,Georgia,0,0,6,6,2000
69,Costa Rica,0,0,2,2,2000
70,Portugal,0,0,2,2,2000
71,Armenia,0,0,1,1,2000
72,Barbados,0,0,1,1,2000
73,Chile,0,0,1,1,2000
74,Iceland,0,0,1,1,2000
75,India,0,0,1,1,2000
76,Israel,0,0,1,1,2000
77,Kuwait,0,0,1,1,2000
78,Kyrgyzstan,0,0,1,1,2000
79,Macedonia,0,0,1,1,2000
80,Qatar,0,0,1,1,2000
1,United States,36,39,26,101,2004
2,China,32,17,14,63,2004
3,Russia,28,26,36,90,2004
4,Australia,17,16,17,50,2004
5,Japan,16,9,12,37,2004
6,Germany,13,16,20,49,2004
7,France,11,9,13,33,2004
8,Italy,10,11,11,32,2004
9,South Korea,9,12,9,30,2004
10,Great Britain,9,9,12,30,2004
11,Cuba,9,7,11,27,2004
12,Hungary,8,6,3,17,2004
13,Ukraine,8,5,9,22,2004
14,Romania,8,5,6,19,2004
15,Greece,6,6,4,16,2004
16,Brazil,5,2,3,10,2004
17,Norway,5,0,1,6,2004
18,Netherlands,4,9,9,22,2004
19,Sweden,4,2,1,7,2004
20,Spain,3,11,6,20,2004
21,Canada,3,6,3,12,2004
22,Turkey,3,3,4,10,2004
23,Poland,3,2,5,10,2004
24,New Zealand,3,2,0,5,2004
25,Thailand,3,1,4,8,2004
26,Belarus,2,5,6,13,2004
27,Austria,2,4,1,7,2004
28,Ethiopia,2,3,2,7,2004
29,Iran,2,2,2,6,2004
30,Slovakia,2,2,2,6,2004
31,Chinese Taipei,2,2,1,5,2004
32,Georgia,2,2,0,4,2004
33,Bulgaria,2,1,9,12,2004
34,Denmark,2,1,5,8,2004
35,Jamaica,2,1,2,5,2004
36,Uzbekistan,2,1,2,5,2004
37,Morocco,2,1,0,3,2004
38,Argentina,2,0,4,6,2004
39,Chile,2,0,1,3,2004
40,Kazakhstan,1,4,3,8,2004
41,Kenya,1,4,2,7,2004
42,Czech Republic,1,3,5,9,2004
43,South Africa,1,3,2,6,2004
44,Croatia,1,2,2,5,2004
45,Lithuania,1,2,0,3,2004
46,Egypt,1,1,3,5,2004
47,Switzerland,1,1,3,5,2004
48,Indonesia,1,1,2,4,2004
49,Zimbabwe,1,1,1,3,2004
50,Azerbaijan,1,0,4,5,2004
51,Belgium,1,0,2,3,2004
52,Bahamas,1,0,1,2,2004
53,Israel,1,0,1,2,2004
54,Cameroon,1,0,0,1,2004
55,Dominican Republic,1,0,0,1,2004
56,United Arab Emirates,1,0,0,1,2004
57,North Korea,0,4,1,5,2004
58,Latvia,0,4,0,4,2004
59,Mexico,0,3,1,4,2004
60,Portugal,0,2,1,3,2004
61,Finland,0,2,0,2,2004
62,Serbia and Montenegro,0,2,0,2,2004
63,Slovenia,0,1,3,4,2004
64,Estonia,0,1,2,3,2004
65,Hong Kong,0,1,0,1,2004
66,India,0,1,0,1,2004
67,Paraguay,0,1,0,1,2004
68,Colombia,0,0,2,2,2004
69,Nigeria,0,0,2,2,2004
70,Venezuela,0,0,2,2,2004
71,Eritrea,0,0,1,1,2004
72,Mongolia,0,0,1,1,2004
73,Syria,0,0,1,1,2004
74,Trinidad and Tobago,0,0,1,1,2004
1,China,48,22,30,100,2008
2,United States,36,39,37,112,2008
3,Russia,24,13,23,60,2008
4,Great Britain,19,13,19,51,2008
5,Germany,16,11,14,41,2008
6,Australia,14,15,17,46,2008
7,South Korea,13,11,8,32,2008
8,Japan,9,8,8,25,2008
9,Italy,8,9,10,27,2008
10,France,7,16,20,43,2008
11,Netherlands,7,5,4,16,2008
12,Ukraine,7,4,11,22,2008
13,Kenya,6,4,6,16,2008
14,Spain,5,11,3,19,2008
15,Jamaica,5,4,2,11,2008
16,Poland,4,5,2,11,2008
17,Ethiopia,4,2,1,7,2008
18,Romania,4,1,4,9,2008
19,Cuba,3,10,17,30,2008
20,Canada,3,9,8,20,2008
21,Hungary,3,5,2,10,2008
22,Norway,3,5,1,9,2008
23,Brazil,3,4,10,17,2008
24,Belarus,3,4,7,14,2008
25,Czech Republic,3,3,1,7,2008
26,Slovakia,3,3,0,6,2008
27,New Zealand,3,2,4,9,2008
28,Georgia,3,2,2,7,2008
29,Kazakhstan,2,3,4,9,2008
30,Denmark,2,2,3,7,2008
31,North Korea,2,2,2,6,2008
32,Thailand,2,2,2,6,2008
33,Mongolia,2,2,0,4,2008
34,Switzerland,2,1,4,7,2008
35,Argentina,2,0,4,6,2008
36,Mexico,2,0,2,4,2008
37,Belgium,2,0,0,2,2008
38,Zimbabwe,1,3,0,4,2008
39,Slovenia,1,2,2,5,2008
40,Azerbaijan,1,1,4,6,2008
41,Indonesia,1,1,4,6,2008
42,Bulgaria,1,1,3,5,2008
43,Turkey,1,1,3,5,2008
44,Chinese Taipei,1,1,2,4,2008
45,Finland,1,1,2,4,2008
46,Latvia,1,1,1,3,2008
47,Dominican Republic,1,1,0,2,2008
48,Estonia,1,1,0,2,2008
49,Portugal,1,1,0,2,2008
50,Trinidad and Tobago,1,1,0,2,2008
51,India,1,0,2,3,2008
52,Iran,1,0,1,2,2008
53,Cameroon,1,0,0,1,2008
54,Panama,1,0,0,1,2008
55,Tunisia,1,0,0,1,2008
56,Sweden,0,4,1,5,2008
57,Lithuania,0,3,2,5,2008
58,Nigeria,0,3,2,5,2008
59,Croatia,0,2,3,5,2008
60,Colombia,0,2,1,3,2008
61,Greece,0,2,1,3,2008
62,Armenia,0,1,4,5,2008
63,Uzbekistan,0,1,3,4,2008
64,Austria,0,1,2,3,2008
65,Ireland,0,1,2,3,2008
66,Kyrgyzstan,0,1,2,3,2008
67,Serbia,0,1,2,3,2008
68,Algeria,0,1,1,2,2008
69,Bahamas,0,1,1,2,2008
70,Morocco,0,1,1,2,2008
71,Tajikistan,0,1,1,2,2008
72,Chile,0,1,0,1,2008
73,Ecuador,0,1,0,1,2008
74,Iceland,0,1,0,1,2008
75,Malaysia,0,1,0,1,2008
76,Samoa,0,1,0,1,2008
77,Singapore,0,1,0,1,2008
78,South Africa,0,1,0,1,2008
79,Sudan,0,1,0,1,2008
80,Vietnam,0,1,0,1,2008
81,Egypt,0,0,2,2,2008
82,Afghanistan,0,0,1,1,2008
83,Israel,0,0,1,1,2008
84,Mauritius,0,0,1,1,2008
85,Moldova,0,0,1,1,2008
86,Togo,0,0,1,1,2008
87,Venezuela,0,0,1,1,2008
1,United States,48,26,30,104,2012
2,China,39,31,22,92,2012
3,Great Britain,29,18,18,65,2012
4,Russia,18,21,26,65,2012
5,South Korea,13,9,9,31,2012
6,Germany,11,20,13,44,2012
7,France,11,11,13,35,2012
8,Australia,8,15,12,35,2012
9,Italy,8,9,11,28,2012
10,Hungary,8,4,6,18,2012
11,Japan,7,14,17,38,2012
12,Iran,7,5,1,13,2012
13,Netherlands,6,6,8,20,2012
14,New Zealand,6,2,5,13,2012
15,Ukraine,5,4,10,19,2012
16,Cuba,5,3,7,15,2012
17,Spain,4,10,6,20,2012
18,Jamaica,4,5,4,13,2012
19,Czech Republic,4,4,3,11,2012
20,South Africa,4,1,1,6,2012
21,North Korea,4,0,3,7,2012
22,Brazil,3,5,9,17,2012
23,Kazakhstan,3,2,6,11,2012
24,Poland,3,2,6,11,2012
25,Ethiopia,3,2,3,8,2012
26,Croatia,3,1,2,6,2012
27,Canada,2,6,10,18,2012
28,Belarus,2,5,3,10,2012
29,Kenya,2,4,7,13,2012
30,Denmark,2,4,3,9,2012
31,Romania,2,4,1,7,2012
32,Azerbaijan,2,2,5,9,2012
33,Switzerland,2,2,0,4,2012
34,Norway,2,1,1,4,2012
35,Lithuania,2,0,3,5,2012
36,Tunisia,2,0,1,3,2012
37,Sweden,1,4,3,8,2012
38,Colombia,1,3,5,9,2012
39,Mexico,1,3,4,8,2012
40,Georgia,1,2,3,6,2012
41,Ireland,1,1,4,6,2012
42,Argentina,1,1,2,4,2012
43,Serbia,1,1,2,4,2012
44,Slovenia,1,1,2,4,2012
45,Trinidad and Tobago,1,1,2,4,2012
46,Turkey,1,1,1,3,2012
47,Dominican Republic,1,1,0,2,2012
48,Chinese Taipei,1,0,1,2,2012
49,Latvia,1,0,1,2,2012
50,Algeria,1,0,0,1,2012
51,Bahamas,1,0,0,1,2012
52,Bahrain,1,0,0,1,2012
53,Grenada,1,0,0,1,2012
54,Uganda,1,0,0,1,2012
55,Venezuela,1,0,0,1,2012
56,Egypt,0,3,1,4,2012
57,India,0,2,4,6,2012
58,Mongolia,0,2,3,5,2012
59,Thailand,0,2,2,4,2012
60,Bulgaria,0,2,1,3,2012
61,Finland,0,2,1,3,2012
62,Indonesia,0,2,1,3,2012
63,Slovakia,0,1,3,4,2012
64,Belgium,0,1,2,3,2012
65,Armenia,0,1,1,2,2012
66,Estonia,0,1,1,2,2012
67,Malaysia,0,1,1,2,2012
68,Puerto Rico,0,1,1,2,2012
69,Qatar,0,1,1,2,2012
70,Botswana,0,1,0,1,2012
71,Cyprus,0,1,0,1,2012
72,Gabon,0,1,0,1,2012
73,Guatemala,0,1,0,1,2012
74,Montenegro,0,1,0,1,2012
75,Portugal,0,1,0,1,2012
76,Uzbekistan,0,0,3,3,2012
77,Greece,0,0,2,2,2012
78,Singapore,0,0,2,2,2012
79,Afghanistan,0,0,1,1,2012
80,Cameroon,0,0,1,1,2012
81,Hong Kong,0,0,1,1,2012
82,Kuwait,0,0,1,1,2012
83,Morocco,0,0,1,1,2012
84,Saudi Arabia,0,0,1,1,2012
85,Tajikistan,0,0,1,1,2012
86,Vietnam,0,0,1,1,2012
1,United States,46,37,38,121,2016
2,Great Britain,27,23,17,67,2016
3,China,26,18,26,70,2016
4,Russia,19,17,20,56,2016
5,Germany,17,10,15,42,2016
6,Japan,12,8,21,41,2016
7,France,10,18,14,42,2016
8,South Korea,9,3,9,21,2016
9,Italy,8,12,8,28,2016
10,Australia,8,11,10,29,2016
11,Netherlands,8,7,4,19,2016
12,Hungary,8,3,4,15,2016
13,Brazil,7,6,6,19,2016
14,Spain,7,4,6,17,2016
15,Kenya,6,6,1,13,2016
16,Jamaica,6,3,2,11,2016
17,Croatia,5,3,2,10,2016
18,Cuba,5,2,4,11,2016
19,New Zealand,4,9,5,18,2016
20,Canada,4,3,15,22,2016
21,Uzbekistan,4,2,7,13,2016
22,Colombia,3,2,3,8,2016
23,Switzerland,3,2,2,7,2016
24,Iran,3,1,4,8,2016
25,Greece,3,1,2,6,2016
26,Argentina,3,1,0,4,2016
27,Denmark,2,6,7,15,2016
28,Sweden,2,6,3,11,2016
29,South Africa,2,6,2,10,2016
30,Kazakhstan,2,5,10,17,2016
31,Ukraine,2,5,4,11,2016
32,Serbia,2,4,2,8,2016
33,Poland,2,3,6,11,2016
34,North Korea,2,3,2,7,2016
35,Belgium,2,2,2,6,2016
36,Thailand,2,2,2,6,2016
37,Slovakia,2,2,0,4,2016
38,Georgia,2,1,4,7,2016
39,Azerbaijan,1,7,10,18,2016
40,Belarus,1,4,4,9,2016
41,Turkey,1,3,4,8,2016
42,Armenia,1,3,0,4,2016
43,Czech Republic,1,2,7,10,2016
44,Ethiopia,1,2,5,8,2016
45,Slovenia,1,2,1,4,2016
46,Indonesia,1,2,0,3,2016
47,Romania,1,1,2,4,2016
48,Bahrain,1,1,0,2,2016
49,Vietnam,1,1,0,2,2016
50,Chinese Taipei,1,0,2,3,2016
51,Bahamas,1,0,1,2,2016
52,Independent Olympic Athletes,1,0,1,2,2016
53,Ivory Coast,1,0,1,2,2016
54,Fiji,1,0,0,1,2016
55,Jordan,1,0,0,1,2016
56,Kosovo,1,0,0,1,2016
57,Puerto Rico,1,0,0,1,2016
58,Singapore,1,0,0,1,2016
59,Tajikistan,1,0,0,1,2016
60,Malaysia,0,4,1,5,2016
61,Mexico,0,3,2,5,2016
62,Venezuela,0,2,1,3,2016
63,Algeria,0,2,0,2,2016
64,Ireland,0,2,0,2,2016
65,Lithuania,0,1,3,4,2016
66,Bulgaria,0,1,2,3,2016
67,India,0,1,1,2,2016
68,Mongolia,0,1,1,2,2016
69,Burundi,0,1,0,1,2016
70,Grenada,0,1,0,1,2016
71,Niger,0,1,0,1,2016
72,Philippines,0,1,0,1,2016
73,Qatar,0,1,0,1,2016
74,Norway,0,0,4,4,2016
75,Egypt,0,0,3,3,2016
76,Tunisia,0,0,3,3,2016
77,Israel,0,0,2,2,2016
78,Austria,0,0,1,1,2016
79,Dominican Republic,0,0,1,1,2016
80,Estonia,0,0,1,1,2016
81,Finland,0,0,1,1,2016
82,Morocco,0,0,1,1,2016
83,Nigeria,0,0,1,1,2016
84,Portugal,0,0,1,1,2016
85,Trinidad and Tobago,0,0,1,1,2016
86,United Arab Emirates,0,0,1,1,2016
1,United States,39,41,33,113,2020
2,China,38,32,19,89,2020
3,Japan,27,14,17,58,2020
4,Great Britain,22,20,22,64,2020
5,ROC,20,28,23,71,2020
6,Australia,17,7,22,46,2020
7,Netherlands,10,12,14,36,2020
8,France,10,12,11,33,2020
9,Germany,10,11,16,37,2020
10,Italy,10,10,20,40,2020
11,Canada,7,7,10,24,2020
12,Brazil,7,6,8,21,2020
13,New Zealand,7,6,7,20,2020
14,Cuba,7,3,5,15,2020
15,Hungary,6,7,7,20,2020
16,South Korea,6,4,10,20,2020
17,Poland,4,5,5,14,2020
18,Czech Republic,4,4,3,11,2020
19,Kenya,4,4,2,10,2020
20,Norway,4,2,2,8,2020
21,Jamaica,4,1,4,9,2020
22,Spain,3,8,6,17,2020
23,Sweden,3,6,0,9,2020
24,Switzerland,3,4,6,13,2020
25,Denmark,3,4,4,11,2020
26,Croatia,3,3,2,8,2020
27,Iran,3,2,2,7,2020
28,Serbia,3,1,5,9,2020
29,Belgium,3,1,3,7,2020
30,Bulgaria,3,1,2,6,2020
31,Slovenia,3,1,1,5,2020
32,Uzbekistan,3,0,2,5,2020
33,Georgia,2,5,1,8,2020
34,Chinese Taipei,2,4,6,12,2020
35,Turkey,2,2,9,13,2020
36,Greece,2,1,1,4,2020
37,Uganda,2,1,1,4,2020
38,Ecuador,2,1,0,3,2020
39,Ireland,2,0,2,4,2020
40,Israel,2,0,2,4,2020
41,Qatar,2,0,1,3,2020
42,Bahamas,2,0,0,2,2020
43,Kosovo,2,0,0,2,2020
44,Ukraine,1,6,12,19,2020
45,Belarus,1,3,3,7,2020
46,Romania,1,3,0,4,2020
47,Venezuela,1,3,0,4,2020
48,India,1,2,4,7,2020
49,Hong Kong,1,2,3,6,2020
50,Philippines,1,2,1,4,2020
51,Slovakia,1,2,1,4,2020
52,South Africa,1,2,0,3,2020
53,Austria,1,1,5,7,2020
54,Egypt,1,1,4,6,2020
55,Indonesia,1,1,3,5,2020
56,Ethiopia,1,1,2,4,2020
57,Portugal,1,1,2,4,2020
58,Tunisia,1,1,0,2,2020
59,Estonia,1,0,1,2,2020
60,Fiji,1,0,1,2,2020
61,Latvia,1,0,1,2,2020
62,Thailand,1,0,1,2,2020
63,Bermuda,1,0,0,1,2020
64,Morocco,1,0,0,1,2020
65,Puerto Rico,1,0,0,1,2020
66,Colombia,0,4,1,5,2020
67,Azerbaijan,0,3,4,7,2020
68,Dominican Republic,0,3,2,5,2020
69,Armenia,0,2,2,4,2020
70,Kyrgyzstan,0,2,1,3,2020
71,Mongolia,0,1,3,4,2020
72,Argentina,0,1,2,3,2020
73,San Marino,0,1,2,3,2020
74,Jordan,0,1,1,2,2020
75,Malaysia,0,1,1,2,2020
76,Nigeria,0,1,1,2,2020
77,Bahrain,0,1,0,1,2020
78,Lithuania,0,1,0,1,2020
79,Namibia,0,1,0,1,2020
80,North Macedonia,0,1,0,1,2020
81,Saudi Arabia,0,1,0,1,2020
82,Turkmenistan,0,1,0,1,2020
83,Kazakhstan,0,0,8,8,2020
84,Mexico,0,0,4,4,2020
85,Finland,0,0,2,2,2020
86,Botswana,0,0,1,1,2020
87,Burkina Faso,0,0,1,1,2020
88,Ghana,0,0,1,1,2020
89,Grenada,0,0,1,1,2020
90,Ivory Coast,0,0,1,1,2020
91,Kuwait,0,0,1,1,2020
92,Moldova,0,0,1,1,2020
93,Syria,0,0,1,1,2020
1,United States,40,44,42,126,2024
2,China,40,27,24,91,2024
3,Japan,20,12,13,45,2024
4,Australia,18,19,16,53,2024
5,France,16,26,22,64,2024
6,Netherlands,15,7,12,34,2024
7,Great Britain,14,22,29,65,2024
8,South Korea,13,9,10,32,2024
9,Italy,12,13,15,40,2024
10,Germany,12,13,8,33,2024
11,New Zealand,10,7,3,20,2024
12,Canada,9,7,11,27,2024
13,Uzbekistan,8,2,3,13,2024
14,Hungary,6,7,6,19,2024
15,Spain,5,4,9,18,2024
16,Sweden,4,4,3,11,2024
17,Kenya,4,2,5,11,2024
18,Norway,4,1,3,8,2024
19,Ireland,4,0,3,7,2024
20,Brazil,3,7,10,20,2024
21,Iran,3,6,3,12,2024
22,Ukraine,3,5,4,12,2024
23,Romania,3,4,2,9,2024
24,Georgia,3,3,1,7,2024
25,Belgium,3,1,6,10,2024
26,Bulgaria,3,1,3,7,2024
27,Serbia,3,1,1,5,2024
28,Czech Republic,3,0,2,5,2024
29,Denmark,2,2,5,9,2024
30,Azerbaijan,2,2,3,7,2024
31,Croatia,2,2,3,7,2024
32,Cuba,2,1,6,9,2024
33,Bahrain,2,1,1,4,2024
34,Slovenia,2,1,0,3,2024
35,Chinese Taipei,2,0,5,7,2024
36,Austria,2,0,3,5,2024
37,Hong Kong,2,0,2,4,2024
38,Philippines,2,0,2,4,2024
39,Algeria,2,0,1,3,2024
40,Indonesia,2,0,1,3,2024
41,Israel,1,5,1,7,2024
42,Poland,1,4,5,10,2024
43,Kazakhstan,1,3,3,7,2024
44,Jamaica,1,3,2,6,2024
45,South Africa,1,3,2,6,2024
46,Thailand,1,3,2,6,2024
47,Individual Neutral Athletes,1,3,1,5,2024
48,Ethiopia,1,3,0,4,2024
49,Switzerland,1,2,5,8,2024
50,Ecuador,1,2,2,5,2024
51,Portugal,1,2,1,4,2024
52,Greece,1,1,6,8,2024
53,Argentina,1,1,1,3,2024
54,Egypt,1,1,1,3,2024
55,Tunisia,1,1,1,3,2024
56,Botswana,1,1,0,2,2024
57,Chile,1,1,0,2,2024
58,Saint Lucia,1,1,0,2,2024
59,Uganda,1,1,0,2,2024
60,Dominican Republic,1,0,2,3,2024
61,Guatemala,1,0,1,2,2024
62,Morocco,1,0,1,2,2024
63,Dominica,1,0,0,1,2024
64,Pakistan,1,0,0,1,2024
65,Turkey,0,3,5,8,2024
66,Mexico,0,3,2,5,2024
67,Armenia,0,3,1,4,2024
68,Colombia,0,3,1,4,2024
69,Kyrgyzstan,0,2,4,6,2024
70,North Korea,0,2,4,6,2024
71,Lithuania,0,2,2,4,2024
72,India,0,1,5,6,2024
73,Moldova,0,1,3,4,2024
74,Kosovo,0,1,1,2,2024
75,Cyprus,0,1,0,1,2024
76,Fiji,0,1,0,1,2024
77,Jordan,0,1,0,1,2024
78,Mongolia,0,1,0,1,2024
79,Panama,0,1,0,1,2024
80,Tajikistan,0,0,3,3,2024
81,Albania,0,0,2,2,2024
82,Grenada,0,0,2,2,2024
83,Malaysia,0,0,2,2,2024
84,Puerto Rico,0,0,2,2,2024
85,Cape Verde,0,0,1,1,2024
86,Ivory Coast,0,0,1,1,2024
87,Peru,0,0,1,1,2024
88,Qatar,0,0,1,1,2024
89,Refugee Olympic Team,0,0,1,1,2024
90,Singapore,0,0,1,1,2024
91,Slovakia,0,0,1,1,2024
92,Zambia,0,0,1,1,2024
